7 14
#-----@-----#
| R         |
| F         |
|         o |
|           |
|p H Q S P  |
#-----------#
